NO ./textures/wall48.xpm
SO ./textures/wall48.xpm
WE ./textures/wall48.xpm
EA ./textures/wall48.xpm
F 30,220,30
C 30,192,64

        1111111111111111111111111
        1000000000110000000000001
        1011000001110000000000001
        1001000000000000000000001
111111111011000001110000000000001
100000000011000001110111111111111
11110111111111011100000010001
1111N111111111011101010000001
11000000110101011100000000001
10000000000000001100000000001
10000000000000001101010000001
110000011101010111110100100111
11110111 1110101 101111010001
11111111 1111111 111111111111