NO textures/north.png
SO textures/south.xpm
WE textures/west.xpm
EA textures/east.xpm

F 0,64,64
C 224,128,0

11111111
10001101
10000111  111
10000111  101
10N00001  111
10000001
11000001
10000001
10000001
10000111
111111
