NO ./textures/1_1sqbig.xpm
SO ./textures/1_1sqbig.xpm
WE ./textures/1_1sqbig.xpm
EA ./textures/1_1sqbig.xpm
F 0, 255, 255
C 255, 196, 196

1111111111111
1000000000001
1000000000001
10000E0000011
1000000100001
1000000100001
1000000000001
1000000000001
1111111111111
