NO ./textures/2_1h1.xpm
SO    ./textures/2_1h2.xpm
WE ./textures/1_2v1.xpm
EA ./textures/1_2v2.xpm
F 96,   0, 0
C 255, 160,160

11111111111111
10000000000011
11110100000001
11110111111111
11110101001001
10000001001001
10000000000001
1000S000000001
11111111111111
