NO textures/abbey_north.xpm
SO textures/abbey_south.xpm
WE textures/abbey_west.xpm
EA textures/abbey_east.xpm

F 0,64,64
C 160,96,0
        1111111111111111111111111
        1000000000110000000000001
        1011000001110000000000001
        1001000000000000000000001
111111111011000001110000000000001
100000000011000001110111111111011
1111011111111101110000001000000011111
1111011111111101110101001000000000001
1100000011010101110000001000000000001
1000000000000000110000000000000000001
1000N00000000000110101001000000001111
1100000111010101111101111000000000001
11110111 1110101 10111101000000000001
10000001 1000001 10000000000011100001
11111111 1111111 11111111111111111111
