NO textures/abbey_north.xpm
SO textures/abbey_south.xpm
WE textures/abbey_west.xpm
EA textures/abbey_east.xpm

F 0,64,64
C 160,96,0

                                          1111111     1111111111111
                                          1000001     1000001000001
                                          1000001     1000001000001
                                          1000001     1000001000001
                                          1000001     1000001000001
                                          1000001     1000001000001
1111111111111     1111111111111111111111111000001111111111011011111111111
1001001000101     1000100000001000000000001000001000001000000000001000001
1000011000001     1000000000001000000000000000000000001000000000000000001
1000001000001     1010100000001000000000001000000000000000000000001000001
1000000000001     1010100000000000000000001000000000001000000000000000001
1000001000001     1000000000001000000000001000001000001000000000001000001
1111111100111111111000001111111111111110011101011100001111111111111110111
      1000100000000000001000001000000000001000001000000000000000001000001
      1000100001111000001000000000000000001000001000000000000000001000001
      1101100000001100001000000000000000000000000000000000000000000000001
      1000001010101000101000000000000000001000001000000000000000001000001
      1000000000000000101000000000000000011100011100000000000000001000001
      1101001111111010001111111111111111111000001111111111111111111010101
      1000001     1000001000000000011100001000001000011100000000000000001
      1000101     1010001000000000001100001000001000011000000000000000001
      1000001     1000001000000000001100000000000000011000000000000000001
      1000101     1010001000000000001100001000001000011010101010101010001
      1000001     1000001000000000001100001000001000011000000000000000001
      1000101111111010001000011111011100000000000000011010000000000010001
      1000000000000000001000010000001100001000001000011000000000000000001
      1000001010101001001000010000001100001000001000011010000000000010001
      1000000000000000001000011000001100000000000000011000000101000000001
      1000000000000001001000001000001100001000001000011010000000000010001
      1000000000000000001000001110111100001000001000011000000101000000001
1111111101011110111101011111111000001100000000000000011010000000000010001
1001011000001000000100000001001000001100001000001000011000000000000000001
1001011000000000000000000000001000001100001000001000011010000000000010001
1000011000001000000100000000001000001100000000000000011000000000000000001
1000011000001000000110000001111000001100001000001000011010101010101010001
1000000000001000000000000001001000001100001000001000011000000000000000001
1111111111111000000000000001001000001100000000000000011000001111111111111
            1000000000000011001000001100001000001000011000001
            1000000000000000001000001100001000001000011000001
            1000000000000000001000001100000000000000011100011
            1000000000000000000000001100001000001000011000001
            1000000000000011111000001111101000001011111000001
            111111111111111   1000001100001100011000011100011
                              1000001000111100011110001000001
                              1000001000100000000010001000001
                              1000001111100000000011111000001
                              100000000000000N000000000000001
                              1000000000000000000000000000001
                              1111111111111111111111111111111