NO textures/EPF.xpm
SO textures/Artic.xpm
WE textures/rookie.xpm
EA textures/Herbert.xpm

F 255,255,255
C 34,113,179

11111
1000111
10100W1
1000111
11111