NO ./textures/abbey_north.xpm
SO ./textures/abbey_south.xpm
WE ./textures/abbey_west.xpm
EA ./textures/abbey_east.xpm
F 175,113,53
C 0,170,228
        1111111111111111111111111
        1000000000010000000000001
        101100000000100000000001
        1001000000000000000000001
111111111011000001110000000000001
100000000011000001110111111111111
11110111111111011100000010001
11110111111111011101010010001
11000000110101011100000010001
10000000000000001100000010001
1000N000000000001101010010001
1100000111010101111101111000111
11110111 1110101 101111010001
11111111 1111111 111111111111